111111111111111
1P0000000000001
1100000000000C1
100000000000111
100000000000001
1000000000000E1
111111111111111