111101111
1P00000C1
1000000E1
111111111