1111111111111
1P000C00C0011
110000C0000E1
1111111111111
