111111111111111111111111111111
100000000000000000000000000001
100000000000000000000000000001
1P0000000000000000000000000001
111111111111111111111111111111
