111111111111111
1P0000000000001
111111111111101
100000000000001
111111111111111
