111111111
1C00C0C01
1P00000X1
111111111
