111111111
100000001
1P0000001
111111111
